愠	慍
抬	擡
卧	臥
偽	僞
敚	敓
台	臺
枴	柺
粧	妝
悦	悅
氲	氳
户	戶
蜕	蛻
醖	醞
温	溫
媪	媼
税	稅
閲	閱
為	爲
鈎	鉤
韁	繮
粽	糉
鋭	銳
敍	敘
贋	贗
腽	膃
濕	溼
兑	兌
脱	脫
溈	潙
皂	皁
捝	挩
葱	蔥
囱	囪
歎	嘆
灶	竈
踴	踊
枱	檯
藴	蘊
胄	冑
稜	棱
巖	岩
才	纔
叁	叄
媯	嬀
輼	轀
宂	冗
痺	痹
湧	涌
棁	梲
緼	縕
眾	衆
勛	勳
鰛	鰮
鼈	鱉
涚	涗
痴	癡
核	覈
揾	搵
嫻	嫺
啟	啓
煴	熅
裊	嫋
蒀	蒕
榅	榲
潀	潨
説	說
蒍	蔿
衞	衛
缽	鉢
煙	菸
