痺	痹
稜	棱
汙	污
才	纔
蒍	蔿
麵	麪
晒	曬
媯	嬀
床	牀
湧	涌
凶	兇
著	着
為	爲
眾	衆
洩	泄
峰	峯
粽	糉
么	幺
裡	裏
鯰	鮎
痴	癡
睪	睾
偽	僞
嫻	嫺
溈	潙
踴	踊
潀	潨
核	覈
群	羣
啟	啓
灶	竈
